########################
#                      #
#                      #
#               N      #
#                      #
#   ****               #
#   *S                 #
#    C                 #
#                      #
#                      #
#                      #
=                      #
#                      #
#         M            #
#                      #
#                      #
#                      #
#                      #
#                      #
#               N      #
#                      #
#                      #
#                      #
########################