########################
#                      #
#      m         mm    #
#                      #
#                      #
#      ****     m      #
#      *               #
#      *C              #
#             m        #
#                      #
#         m            #
#                      #
#              m       #
#       m              #
#                      #
#                      #
#                      #
#     mm               #
#      mm              #
#                      #
#            m         #
#                      #
#                      #
########################