########################
#                      #
#                      #
#               N      #
#                      #
#   ****               #
#   *S                 #
#    C                 #
#                      #
#                      #
#         m            #
=                      #
#              m       #
#         M            #
#                      #
#                      #
#                      #
#     m                #
#                      #
#               N      #
#                      #
#                      #
#                      #
########################