#######################
#                     #
#                     #
#                     #    
#                     #    
#            m        #
#   mm                #
#    m                #
#           m         #
#                     #
#    m                #
#                     #
#                m    =
#         m           #
#                     #
#                     #
#                     #
#                     #
#        m            #
#               m     #
#   mm                #
#                     #
#                     #
#######################